#######################################################################
........#.........#.#...........#.....#...#.#.......#.#.#.......#.....#
#.#.#####.###.#####.###.#####.#####.###.#.#.#####.###.#.#####.###.###.#
#.#.....#...#...#.....#...#.#.#...#.....#.#.#.......#...#.....#.....#.#
###.#.###.#.###.#.#.###.###.#.#.#.#######.#.###.#######.#.###.#######.#
#...#.....#.#...#.#.....#...#...#...#.....#.#.......#.#.....#.....#.#.#
#.###.#####.#####.#####.###.#.###.#.#.###.#.#.###.###.#.#####.#.#.#.#.#
#...#.#.............#.#...#...#...#...#...#...#.......#...#...#.#.#...#
###.###############.#.#.#.###.#.#####.#######.#####.###.###.###.#####.#
#.........#.....#.#.#.#.#.#.#.#.#.....#.#.#.....#.......#...#.#.......#
#######.###.#####.#.#.#####.#.###.#.###.#.#########.#.#.#####.#########
#.#.#.#.......#.#...#.#.#.#.....#.#.#.#.....#...#...#.#...#.........#.#
#.#.#.#.#.###.#.###.#.#.#.###.###.###.#.#.#.###.#.###.#####.###.###.#.#
#.....#.#.#.....#.........#...#.........#.#.....#...#.....#...#.#.....#
###.#####.#############.###.#####.#.#.###.#.###.#########.###.#######.#
#.........#...#.#.........#.#.....#.#.#.#.#.#.....#.#.........#...#...#
###.#.#####.###.###.#########.#####.#.#.#######.###.###.#.#####.#.#.#.#
#...#...........#.....#.#.#.......#.#.#...#...#.....#.#.#.#.#.#.#.#.#.#
#.#######.#.#########.#.#.###.#####.#####.#.#####.###.###.#.#.#.#.#####
#...#...#.#.#...#.#...#...#.#.#...#.#.#...#.#...#...........#.#.#.....#
###.#.#######.###.###.#.###.#.#.#.###.###.#.###.###.#####.#.#.#.#######
#...#.#...#...#.......#.#.#...#.#...#.......#.#.....#...#.#...........#
#.###.###.#.#####.#####.#.#########.#.#.#####.###.###.#.###.#.#.###.###
#.......#.#.#.......#...#.#.....#.#.#.#.............#.#.#...#.#...#.#.#
###.#.###.#.#.###.#.###.#.#.#####.#.###.#.#.#.#####.#.###########.###.#
#.#.#.#.........#.#.#...#.....#...#.....#.#.#.#...#...#.#.#.#...#.....#
#.#.###.#####.#####.###.###.#.###.#.###.#.###.#.###.###.#.#.###.#.###.#
#.#.#...#.....#.#...#...#...#.....#.#...#...#...#...#...........#...#.#
#.#####.###.###.#.#.#.#.#.###.#########.#####.#####.#######.###.#.#####
#.....#.#.#.#.....#.#.#...#.#.............#...#.#.#...#.....#.#.#.#...#
#.#.#.###.###.#.#####.#.#.#.#########.#.###.###.#.###.###.#.#.#.#.#.###
#.#.#...#.....#.#.....#.#.#.#.#.#.#...#...#.#.........#...#.#.........#
#####.#####.###.#######.#.#.#.#.#.#######.#####.#####.###############.#
#.............#.#.#.#.#.#...#.........#.#.#.........#.#.#...#.....#.#.#
#########.#####.#.#.#.###.#####.#######.#.#.#######.###.#.#.###.###.#.#
#.#...#.....#.#.#.........#.#.........#...#.....#.......#.#...#.#...#.#
#.###.#.###.#.#.#.#########.#.#.#.#.###.#.#.###########.#####.#.###.###
#.#.....#.....#.#.#.#...#...#.#.#.#.....#.#.#...#.....#.#.....#.....#.#
#.#.#.#######.###.#.#.###.#.#######.#######.#.#.#.#####.#####.#.###.#.#
#...#.#.#.#.#.#...#.....#.#.#...#.#.#.......#.#...#.......#.....#.....#
#######.#.#.#.#####.###.###.###.#.#.#######.#####.#######.#.#########.#
#.......#.#.......#.#.....#.......#.#.#.#...#...........#.......#.#...#
###.#.###.#.#####.#######.#####.###.#.#.#.#.#####.#.#.###.###.###.###.#
#...#.#.......#.#...#...#.#.#...........#.#.#.#...#.#.#.#.#...#.#...#.#
#####.#.###.#.#.#######.#.#.#.#.#.###.#####.#.#####.#.#.#.#.###.#.#####
#...#.....#.#...#...........#.#.#.#.#...#...#.......#...#.#.#.....#.#.#
###.#.###.#######.###.#########.###.#####.#####.#####.###.###.###.#.#.#
#.#...#...#.........#...#...#...........#...#...#...............#.....#
#.#.#######.#########.#.###.#.#####.###.###.#######.#.#####.#####.#####
#.#.......#...#...#...#.#.....#.......#...#...#...#.#.#.#.......#...#.#
#.#.#.###########.###.###.#.#####.###############.#.#.#.#.#########.#.#
#...#...#.....#...........#.#.....#...#.....#.#.....#...#...#.........#
#########.###.###.#.#.#.#.###.#.#####.#.###.#.###########.#########.#.#
#.#.........#.#...#.#.#.#.#...#...#.....#.#...#...#...#.......#.....#.#
#.###.#.###.#.#.###############.#.#######.#.###.#.#.#########.###.#.#.#
#.....#...#.#...#.....#.#...#...#...#.........#.#...#.....#.#...#.#.#.#
#.#.###.#.#.#########.#.###.#.#########.#.#.#.#####.###.#.#.#########.#
#.#.#...#.#...#.#.........#.#.#...#.#...#.#.#...#.#.#...#...#.#.......#
###.#.###.#####.#.###.#.#.#.#####.#.#####.###.###.#.#######.#.###.###.#
#.#.#...#...#...#...#.#.#.#.....#.....#...#.........#.#...........#...#
#.###.#.#.#.###.#########.#.#.#.###.#######.#.#.###.#.###########.#####
#...#.#.#.#.........#.#.#...#.#.#.......#.#.#.#...#...#.#.....#.......#
###.###########.#.###.#.#####.#.#####.#.#.###.#####.#.#.#.#######.###.#
#.#.#.........#.#...#.......#.#...#...#.......#.#.#.#.............#...#
#.#.#.###.#########.###.#####.###.#########.#.#.#.#####.#.#######.#.###
#...#.#.#.............#...#...#.#.#...#.#.#.#...#.#.#...#.......#.#.#.#
###.#.#.#############.###.#####.#.#.#.#.#.#.###.#.#.###.#.#.#######.#.#
#.........#.#.....#.................#.#.#...#.#...#.....#.#.#.#.......#
#.#.#.#####.#.###.###.#####.###.#####.#.#####.#.#.#####.#####.###.#####
#.#.#.#.......#.......#.......#.#.........#.....#.#.........#..........
#######################################################################
