#######################################################################
....#...........#...#...........#.................#.....#.#...........#
###.#.#########.#.#.###.#########.#####.#########.#.###.#.#.#######.#.#
#...#.#.#.....#...#...#.#.........#.....#.......#.#...#.#.....#.#...#.#
#.###.#.#.###.#######.#.#.#######.#.#####.#######.#.#.#.#####.#.#.###.#
#.#...#...#.#.#.....#.#...#.....#.#.#.......#...#.#.#.#...#.....#.#.#.#
#.###.#.###.#.#.#.###.#####.###.###.#######.#.#.#.###.###.#######.#.#.#
#.....#.#...#.#.#...#...#...#.#...#.....#...#.#...#...#...........#.#.#
#######.#.#.#.#.###.###.#.###.###.#####.#.###.#####.###############.#.#
#.#...#.#.#.#...#.#...#.#.#...#...#.....#...#...#...#.....#...#.....#.#
#.#.#.#.#.#.#####.###.#.#.#.#.#.###.#######.###.#.#.#.###.###.#.#.###.#
#...#...#.#.......#...#...#.#.#.....#.....#...#.#.#.#...#...#.#.#.#...#
#.#############.#.#.#.#####.#.#######.###.###.#.#.#.###.###.#.#.#.#.###
#...#.....#...#.#.#.#.....#.#.....#.....#.....#.#.#...#.#.#.#...#...#.#
###.###.#.#.#.#.#.#.#####.#.#####.#.###.#######.#.#.###.#.#.###.#####.#
#.#.....#...#...#.#.#.#...#.#...#...#.#...#.....#.#.....#.#...#...#...#
#.#############.###.#.#.###.###.#####.###.#.#########.###.###.###.###.#
#.............#.#...#.....#.#...#.....#.#...#.......#.......#...#.....#
#########.###.#.#.#####.###.#.###.#.#.#.#####.#.###.###########.#####.#
#.......#...#.#.#.....#.#...#...#.#.#...#.....#...#.............#.#...#
#.#####.###.###.#####.#.#.#####.#.#.###.#.#######.#####.#########.#.###
#...#.#...#.........#.#.#.....#...#...#.#...#...#...#...#.......#...#.#
#.#.#.###.###########.#######.###.###.#####.#.#.###.#.###.#####.#.###.#
#.#.#...#.............#.....#...#...#.#...#.#.#.#...#.#...#.....#.....#
###.#.#######.#########.###.###.###.#.#.#.#.#.#.#.#####.###.#########.#
#...#.........#...........#...#.#...#...#.#...#.#...#.....#.#.........#
#.#############.#############.#.#######.#.#####.###.#.#####.###########
#.........#.....#.#.....#...#.#.#.....#.#.#.....#.#.....#...#.........#
#.#######.#.#####.#.#.#.#.#.#.#.#.###.#.#.#.#####.#######.#.#.#######.#
#.#...#...#.#.......#.#.#.#...#.#.#.#.#.#...#.....#.#.....#.#.......#.#
#.#.###.###.#.#######.#.#.###.#.#.#.#.#.#######.#.#.#.#####.#######.#.#
#...#...#...#...#.....#.#.#...#.#.#.#.#...#.....#...#.#.....#.......#.#
#####.###.###.###.###.###.#####.#.#.#.###.###.#####.#.###.###.#######.#
#...#.......#.#...#...#...#.....#.#...#.......#.....#...#.#...#.#.....#
#.#.#######.###.###.###.#.#.#####.#.#######.###########.###.###.#.###.#
#.#.....#.....#...#...#.#.#...#...#.....#.#.#.....#...#.#.......#...#.#
#.#####.#####.###.#####.#.###.#.#######.#.#.#.###.#.#.#.#.#########.#.#
#...#.#.....#.....#.....#.#.#...#.....#.#...#.#.#.#.#.#...#...#.....#.#
###.#.#####.#####.#.#####.#.#####.###.#.#####.#.#.#.#.#####.#.#.#####.#
#...#.....#.#...#.#.#.#...#.....#.#.#.#.....#.#.#...#.......#...#.....#
#.#####.#.#.#.#.###.#.#.###.#.###.#.#.#####.#.#.#################.#####
#.....#.#...#.#.....#...#...#.#...#.#.....#.#.#.....#...#...#...#.#...#
#.###.###.###.#######.#######.#.###.###.#.#.#.#.#.#.#.#.#.#.#.#.#.#.###
#.#.#...#.#.....#...#...#.....#.#.....#.#.#...#.#.#.#.#...#...#.#.#...#
#.#.###.#.#.###.#.#.###.#.#####.#.#.#.#.#######.#.###.#########.#.#.#.#
#...#...#.#...#.#.#...#.#.#.....#.#.#.#.#...#...#...#.#.....#...#.#.#.#
#.###.###.#####.#.###.#.#.#.#####.#.###.#.#.#.#####.#.###.###.#.#.###.#
#.#...#.......#.....#.#...#.#.....#.#...#.#...#...#.#.....#...#.#...#.#
###.#.#######.#####.#.###.#.###.###.#.###.#####.#.#.#####.#.#######.#.#
#...#.#...#.#.....#.#.#.#.#...#.#...#.....#.....#.#.......#...#.....#.#
#.#####.#.#.#####.###.#.#.###.###.#####.###.#####.#.#########.#.#####.#
#.......#.#.#...#.....#...#.#...#.#...#.#...#.....#.....#.....#.......#
#.#######.#.#.#.#######.###.###.#.#.#.###.###.#####.#####.###.#######.#
#...#.....#...#.....#.......#.....#.#.....#.#.....#.#...#.#...#.....#.#
#####.#####.#####.###.#######.#####.#######.#####.###.#.#.#.###.#####.#
#.....#.#...#...#...#.#.#.....#.....#.#.....#...#...#.#...#.#...#.....#
#.#####.#.###.#.###.#.#.#.#####.#####.#.#.#.#.#.###.#.#####.#.###.#####
#.#.....#.....#...#...#.#.#...#.#.......#.#...#...#.#.#...#.#...#.#...#
#.#.#.###########.#####.#.#.#.#.#.#######.#.#######.#.#.#.#.###.#.#.#.#
#.#.#.#.........#.#.....#...#.#.#...#.....#.#...#...#.#.#.#.....#...#.#
#.#.#.#.#.#####.#.###.#.#.#####.#.###.#######.#.#.###.#.#.###########.#
#.#.#...#.#.....#.#...#.#.#...#.#.#...#...#...#.#...#.#.#...........#.#
#.#######.#######.#.#.###.#.#.#.###.#.#.#.#.###.###.#.#.#########.###.#
#.#.....#...........#.#...#.#...#...#.#.#...#.#.......#.#...#...#.....#
#.#.###.#.#############.###.#####.###.#.#####.#########.#.#.#.#.#######
#.#...#.#.......#.....#.#.#.....#.#...#.#.........#.....#.#.#.#.#.....#
#.###.#.#########.###.#.#.#####.#.#####.#####.#.###.#####.#.#.#.###.#.#
#...#.#.....#.....#.#...#.....#.#.............#.#...#.....#...#...#.#.#
#.###.#####.#.#####.#########.#.#################.#######.#######.###.#
#.........#...................#...........................#............
#######################################################################
