#####################################################################################################
..#.......#.........#.....#...........#...#...........#.#.......................#.....#...#.....#...#
#.#.#.###.#######.#.#####.#.###.#####.###.#.###.#####.#.#.#####.###.###########.#.#.#.#.#.#.###.#.#.#
#.#.#...#.#...#...#.#...#.#...#...#.#...#.#.#...#...#.#...#...#...#...#.......#.#.#.#...#.#...#.#.#.#
#.#####.#.#.#.#.###.#.#.#.###.###.#.###.#.#.#.###.#.#.#####.#.###.###.#.#.###.#.###.#####.###.#.#.###
#.......#...#...#...#.#.#...#...#.#...#.#...#.#.#.#.#.....#.#.#.#.#...#.#.#.#.#...#.#.#...#...#.#...#
#################.###.#.#.#.#.###.#.###.#.###.#.#.#.#####.#.#.#.#.#.###.#.#.#.###.#.#.#.###.###.###.#
#...#.....#.....#...#.#.#.#.#.#...#.....#...#.#...#.....#.#.#.#...#...#.#.#.....#...#.#...#...#.....#
###.#.#.###.###.###.#.#.#.###.#.###.#########.#.#######.#.#.#.###.###.#.#.#####.#####.###.#.#.#####.#
#...#.#.....#.....#...#.#.....#.#.............#.#...#...#...#...#.#...#.#.....#...#.......#.#.#...#.#
#.###.#######.#.#######.#######.#################.#.#.#.#######.###.#####.###.###.#.#########.#.#.#.#
#.....#.#.....#.#.....#...#...#...#.....#.........#.#.#...#...#...#.#...#.#.#.#.#.#...#.....#.#.#.#.#
#.#####.#.#######.#.#####.#.#.###.#.#.#.###.#######.#.###.#.#.###.#.#.#.#.#.#.#.#.###.###.#.#.#.#.#.#
#...#...#.........#.#...#...#.....#.#.#.....#...#...#.#...#.#.#...#...#.#...#.#...#.#.#...#...#.#.#.#
###.#.#.###########.#.#.#############.#######.#.#.###.#.###.###.#######.###.#.#.###.#.#.#########.#.#
#...#.#...#.......#.#.#.......#.......#.......#.#.#...#...#...#.........#...#.#.#...#...#.#.......#.#
#.###.###.#.###.###.#.###.#####.###.###.#.#####.#.#.#####.#.#.###############.#.#.#.#####.#.###.###.#
#...#...#...#.#.#...#...#.......#...#...#.#.#...#.#...#...#.#.#.....#.........#.#.#...#...#...#.....#
###.###.#####.#.#.#.###.#########.#######.#.#.###.#.#.#.#####.#.#.#.###.#######.#.#.###.#.###.#######
#.#.....#.#.....#.#...#...#.#...#.#.......#...#.#.#.#.#.#...#.#.#.#.....#...#...#.#.....#...#.......#
#.#######.#.#####.#######.#.#.#.#.#.#######.###.#.###.#.#.#.#.#.#.#######.###.###.#######.#.#######.#
#...#.......#...#.......#...#.#...#...#.#...#...#.....#...#.#...#...#.....#...#...#...#...#.#.......#
#.###.#######.#######.#.###.#.#####.#.#.#.###.#.###########.#######.#.#.###.#######.#.#.###.#.#######
#.#...#.....#.#.......#...#.#.....#.#.#.....#.#.#.........#.#...#...#.#...........#.#...#...#.#.....#
#.#.###.#.#.#.#.#######.###.#####.#.#.#####.#.#.#.#######.#.#.#.#.###############.#.#####.###.#####.#
#...#...#.#...#.#.......#...#...#.#.#.#...#...#.#.#.....#...#.#.#.#.......#.....#...#.....#.#.....#.#
#.#######.#####.#.#######.###.#.#.#.#.#.#.#######.#####.#####.#.#.#.#####.#.###.#####.#####.#####.#.#
#.......#...#...#...#...#...#.#.#.#.#...#.....#...#...........#.#.#...#.#...#.#.....#.#.....#...#.#.#
#######.###.#.#######.#.###.#.###.#.#########.#.###.###########.#.###.#.#####.#####.#.#####.#.#.#.#.#
#.....#.#...#.........#...#.#.#...#.....#...#...#.#.......#...#...#...#.........#...#.....#.#.#...#.#
#.#.#.#.#.#.###########.###.#.#.#######.#.#######.#.#####.#.#.###.#.###.###.#####.#######.#.#.#####.#
#.#.#.#.#.#...#.....#...#.....#.#.....#.#.#.....#...#...#.#.#.....#...#.#.#.#...#...#.....#.#.......#
#.#.###.#.###.###.#.#.###.#####.###.###.#.#.#.#.#.###.#.#.#.#########.#.#.#.#.#.###.###.###.#######.#
#.#.#...#...#...#.#.#.....#.....#...#...#...#.#.#.....#.#.#.....#...#.#.#...#.#...#...#...#...#...#.#
###.#.#####.###.#.#########.#####.#.#.#######.#.#######.#.#.#####.#.#.#.#.###.###.###.###.#.###.#.#.#
#...#.......#...#.........#...#...#.#.#.......#.....#...#.#.#.....#...#.#.#...#.....#.#.#...#...#...#
#.###########.###.#####.#.###.#.#####.#.###########.#.###.#.#.#########.#.#.#######.#.#.###.#.#######
#.........#.#.#.#.#.....#...#.#.....#.#.#.....#.....#...#.#.#...#...#...#.#.......#...#.#...#.#.....#
#.###.###.#.#.#.#.#.###.#####.#.###.#.#.#####.#.#########.#####.#.#.###.#########.#####.#.###.#.#.###
#...#...#...#.#...#.#...#.....#...#...#...#...#.#.......#.....#.#.#...#.....#.#...#...#...#...#.#...#
#######.#####.#####.#.###.#######.#######.#.###.#.#####.###.#.#.#.###.###.#.#.#.###.#.#.###.#######.#
#.......#...#.#...#.#...#...#...#.#.....#.#...#...#...#.....#.#.#.#.......#...#.....#.#...#.#.......#
#.#######.#.#.#.#.#.#.#####.###.#.###.#.#.###.#######.#.#######.#.###########.#######.#####.#.#.#####
#.........#.#...#.#.#.#.....#...#...#.#.#...#.#.......#.#...#...#.....#.....#.#.....#.....#.#.#.....#
#.#########.#####.#.#.#.#####.#.###.#.#.###.#.#.###.###.#.#.#.#######.#.#####.#.###.#####.#.#####.#.#
#.#.......#.......#.#.#.#.....#...#.#.#.....#.....#.....#.#.#.#.......#.#...#...#.#...#.#.#.....#.#.#
#.#.#####.#########.#.#.###.#######.#.###########.#######.#.#.#.#######.#.#.#####.###.#.#.#####.###.#
#.#.#...#.....#.....#.#...#.........#...#.....#.#.#.......#...#...#.#...#.#.........#.#.#.#...#.....#
#.#.###.###.###.#.###.###.#######.#####.#.###.#.#.#.#############.#.#.#.#.#########.#.#.#.#.#.#####.#
#.#...#.#...#...#...#...#.......#.......#.#.#.#...#.#.....#.#.....#...#.#.........#...#.#...#.#...#.#
#.###.#.#.###.#####.###.#######.#.#####.#.#.#.#####.###.#.#.#.#.#######.#.#######.#####.#####.#.#.#.#
#.#...#.#...#.#...#...#.#.....#.#.#...#.#...#.....#...#.#.#...#...#...#...#...#.......#.....#.#.#...#
#.#.###.###.#.###.###.#.#.#####.###.#.#.###.#####.###.#.#.#####.#.#.#.#####.#.#######.#.#####.#.#####
#.#.#.....#.......#.#.#...#...#.....#.#.#.....#...#.#.#.#.....#.#...#...#...#...#...#...#.....#.....#
#.#.#.#.#.#######.#.#.###.#.#.#######.###.#####.#.#.#.#.#####.#####.###.#.#####.#.#.###.#.#########.#
#.#.#.#.#.#...#.....#.#...#.#.#.....#...#.#.#...#...#.#...#.#.....#...#...#...#.#.#.....#.........#.#
#.#.###.###.#.#######.#####.#.#.#.#####.#.#.#.#######.#.#.#.#####.#.#######.#.#.#.#############.###.#
#.#.....#...#.......#.....#.#...#.....#.#...#...#.....#.#.#.#.....#.#.......#...#.#.........#...#...#
#.#####.#.#########.#.###.#.#########.#.###.###.#.#######.#.#.#####.#.###########.#########.#.###.###
#.....#.#...#...#...#.#.#...#...#.....#.....#...#.#.......#...#...#.#.#.........#.#.......#.#...#...#
#####.#####.#.#.#.###.#.#####.###.###########.#.#.#####.###.###.#.###.#.###.#####.#.#####.#.###.###.#
#...#...#...#.#.#.#.#...#.....#...#.....#.....#.#...#...#.#.....#.....#.#.#.......#...#.#.....#.....#
#.#.###.#.###.###.#.###.#.###.#.###.###.#.#####.###.#.###.#############.#.###########.#.#####.#######
#.#...#...#.....#.#...#.#.#.#.#...#.#.....#...#...#...#...............#.#.....#.....#.#.....#.#...#.#
#.#.#######.###.#.#.#.#.#.#.#.###.#.#######.#.#.#########.#############.###.###.#.#.#.#.###.#.#.#.#.#
#.#.#.......#...#.#.#...#.#.#.#...#...#...#.#.#.#.........#...........#...#.....#.#...#...#.#...#.#.#
#.###.#######.###.#.#####.#.#.#.#.###.#.#.#.#.###.#.#####.#.#########.###.#####.#.#.#####.#######.#.#
#.....#...#...#...#.#.....#...#.#.#.#...#...#.#...#...#...#...#.....#.....#...#.#.#.#...#.......#...#
#.#######.#.###.###.#####.#.###.#.#.#########.#.#####.#.#####.#.#.#########.#.###.###.#.#####.#.###.#
#.#.......#...#.#.#.....#.#...#.#.......#...#.#.#.#...#.#.....#.#...........#.....#...#.....#.#...#.#
#.#.###.#####.#.#.#####.#.###.#.#######.#.#.#.#.#.#.#####.#####.#######.###########.#######.#####.#.#
#.#.#...#...#...#.#...#...#.#.#.#.....#.#.#.#.#...#.#.....#...#...#...#.....#.....#.#.....#...#...#.#
#.###.###.#.#####.#.#.#####.#.#.#####.#.#.#.#.###.#.#.#####.#.###.#.#######.#.###.#.#.#######.#.###.#
#...#...#.#.#.......#.........#.....#...#.#.....#.#...#.....#.#...#.....#...#.#.#...#.#.......#.....#
###.#.#.#.#.#.#####################.###.#.#######.#########.#.#.#####.#.#.###.#.#####.#.###########.#
#...#.#.#.#...#.......#.....#.....#...#.#.......#...#.......#.#.......#.#...#...#.....#...........#.#
#.###.#.#.#####.#####.#.###.#####.###.#.#######.###.#.#.#####.#########.###.###.#.###.###########.###
#...#.#...#.....#...#...#.#.......#.#.#.....#.#...#.#.#.#.....#.....#...#.#...#.#...#...#.......#...#
###.###.###.#######.#####.#######.#.#.#####.#.###.#.###.#####.###.###.###.###.#.#####.#.#.###.#####.#
#.#...#.....#.....#...#...#.....#.#.#...#.#.....#.#...#.#...#.....#.........#.........#.#...#.#.....#
#.###.#######.###.#.###.#.#.#.###.#.###.#.###.###.###.#.#.#.#####.#.###################.#####.#.###.#
#...#.#.....#...#...#...#...#.#...#...#.#...#.#...#...#.#.#...#.#.#.#...........#.....#.......#.#...#
#.###.#.###.#.#.#####.#######.#.###.#.#.#.###.#.###.###.#.###.#.#.#.#.#########.#####.#######.#.#.###
#.....#...#.#.#.....#.#.#.....#.#...#.#.#.....#.....#.....#...#...#.#.#.......#...#.....#.....#.#...#
#.#####.#.#.#.#####.#.#.#.#####.#.###.#.#####.#########.###.#.#####.#.###.#.#####.#.#####.#####.###.#
#...#...#.#.#...#.#...#.#...#...#.#...#.#...#.........#.#...#.#.....#...#.#.....#.#.#.....#.....#.#.#
###.#.###.#####.#.#####.###.#.###.#.###.#.#.#########.###.#####.#######.#.###.###.#.#.#####.#####.#.#
#.#.#.#.#.....#.#.....#...#.......#...#.#.#.....#...#.#...#...........#.#.#.#.....#.....#...#.#.....#
#.#.#.#.#####.#.#.###.###.#######.#####.#.#####.#.#.#.#.###.#######.###.#.#.###########.#.###.#.#####
#.#.#...#...#...#...#.....#.....#.#...#.......#.#.#.#.#.#...#.....#.#...#.....#.......#.#...#.......#
#.#.###.#.#######.#.#####.#.###.###.#.#########.#.#.#.#.#.###.###.#.#.#######.#.#####.#.###.#######.#
#...#.#.#.#...#...#...#...#.#.#.....#.....#...#...#.#.#...#...#...#.#...#...#.#...#...#...#...#...#.#
#.###.#.#.#.#.#.#####.#.###.#.###########.#.#.###.#.#.#.###.###.###.###.#.#.#.###.#.#########.#.#.#.#
#.#.#...#...#...#.....#.#...#...........#...#...#.#.#.#...#.#.#...#...#.#.#.#.....#...........#.#.#.#
#.#.#.###########.#.#####.###.#####.#.#########.#.#.#.#####.#.###.#####.#.#.###################.###.#
#.#...............#.#.....#.#.#.#...#.#.......#.#.#.#.....#.#.#...#...#.#.#.....#...............#...#
#.#.###############.#.#####.#.#.#.#####.#####.#.###.#####.#.#.#.###.#.#.#.#####.#.###.#########.#.###
#.#.#.............#.#.#.....#...#.#...#.....#.#.....#.#...#.#...#...#.#.#.#.....#.#.#.....#.....#...#
#.###.###########.###.#.#.#####.#.#.#.#####.#.#######.#.###.#.#####.#.#.#.#.#####.#.#####.#########.#
#.....#...............#.#.......#...#.......#...............#.......#...#.#.............#............
#####################################################################################################
