#####################################################################################################
................#...#...#.#.....#.#...........#.#.....#.........#.......#.....#.#.#.....#...#.......#
#.###########.###.###.#.#.#####.#.#########.###.###.#.#.#####.#.#####.#######.#.#.#####.###.#.#####.#
#.#.#...#...#.......#.#...#...#...................#.#...#.#...#.#.....#...#...#.#.#.#.#...#.#.#.....#
#.#.#.###.#####.#####.#####.#######.###.#.#.#####.#####.#.###.#.#.#####.#.#.#.#.#.#.#.###.#.###.#####
#...#.........#.......#.......#.#.#.#...#.#...#.....#.....#...#.......#.#.#.#.......................#
#.#######.###.#####.#.#.#.#####.#.#.#####.#######.#####.#######.#####.#.#######.###########.#####.#.#
#...#.....#.#...#.#.#...#...........#.....#.#...#.#.#.#.......#...#.......#.#.......#.#...#...#.#.#.#
#####.#.#.#.###.#.###.#######.#.#####.#####.#.###.#.#.#####.###.#.#####.###.###.#.#.#.###.#.#.#.###.#
#.#...#.#.#.#.......#.#...#...#...#.#.........#.#.#...#.....#.#.#...#.....#.....#.#.....#.#.#...#...#
#.#.#.#####.###.###.#.###.###.###.#.#####.###.#.#####.###.#.#.###.###.#.#.#######.#######.#.#########
#...#.#.#.#.....#.....#.#.#...#.#...#.#.#.#.......#...#...#...#...#...#.#.#...#.........#.#...#...#.#
#.#####.#.#.#########.#.#.###.#.#####.#.#.#.#.#.#####.#####.###.###.#.###.###.#####.#####.#####.#.#.#
#.......#.........#.#.......#.#.....#.#...#.#.#.#...#.......#...#...#...#.#...#.#.......#.....#.#...#
#.#######.#########.###.###.#.#####.#.#.#########.#.###.###.###.#.###.#######.#.#####.#.#.#####.###.#
#.#...#.#...#.....#...#...#.#.#.#.....#.#.#.#.....#...#...#...#.#.#.......#...........#.#.....#.#...#
#.#.###.###.#.#####.###.#######.#.#.###.#.#.#.#.#.#####.#.#.#.#.#.#######.#####.#.#.#######.#.###.###
#.#...#.#...........#.#.......#.#.#...#.....#.#.#...#.#.#.#.#.#.#.#...#.#.#.....#.#.....#.#.#.......#
###.###.#####.###.###.###.#.#.#.###.#.#.#######.#.###.#####.#######.###.#.#######.#######.#.###.#.#.#
#.#.......#.#...#.....#.#.#.#.#.....#.#...#.#.#.#...#.#.....#.......#.......#.#...#...#.#...#...#.#.#
#.###.#####.#####.#####.#.###.###.#####.###.#.###.###.#####.#.###.#########.#.#.###.#.#.###.#.#.#.#.#
#.......#.....#...#.....#.#.#.#...#...#...#.#...#.#.#.......#...#.......#...#.#...#.#...#.#.#.#.#.#.#
###.#####.###.#.#.###.#####.#####.###.#.###.###.#.#.###.#######.###.###.#.###.#.###.###.#.#.#########
#.#.#...#...#...#.#.#...........#...#.....#.......#...#.....#...#...#.....#.......#.#.....#.#...#...#
#.#.#.#######.#####.###.#.#######.#.#.#.###.#.#.#.#.#.#.###.#################.###.#.#####.#.#.#.#.#.#
#.......#...#.....#.....#...#.#...#.#.#...#.#.#.#...#.#...#...#...#...#.....#.#.......#.#.....#.#.#.#
#.#.#.###.###.#.#.#####.#.#.#.#####.###.#######.#######.#.#######.#.###.#.#.#####.#.###.###.#####.###
#.#.#.....#...#.#.#.#...#.#.#...#.#.................#.#.#.......#...#...#.#.#...#.#...#.........#...#
#########.###.#.###.###.#.#.#.###.#.#######.#########.###.#.###.#.#######.#.#.#####.###.#.#####.#.#.#
#.#.#...#.....#.#...#.#.#.#.#...#.#.#...........#.....#...#...#.#.....#.#.#...#.....#...#.....#...#.#
#.#.#.###.#####.###.#.#.#####.###.#.#.#######.#.#.#####.###.###.#.#.###.#.#.#######.#####.#######.#.#
#.#.#.#.....#.#.......#.....#.#.#...#.#...#...#.#...#.....#...#...#.#.....#.#.#...#.#...........#.#.#
#.#.#.###.#.#.#.###.###.#####.#.#.#####.###.#####.#.###.#####.###.#####.###.#.###.###.#############.#
#.........#.#...#.#.#.#.#...#...........#.........#.#.#.#...#.#...........#.....................#...#
#####.#.#.#######.#.#.#.#.#.###.###.#########.#######.#.#.#######.###.#####.###.#.###.#############.#
#...#.#.#.....#.#.........#.#.#.#.....#...........#.#.....#.#.....#...#.#...#...#.#.....#.....#.#...#
#.#############.#.#.#.#####.#.#####.###.#.#.#.#.#.#.#####.#.#.###.###.#.#.#.#.#####.#.#.#.###.#.#.###
#...............#.#.#...#.........#...#.#.#.#.#.#.....#.#...#.#...#.#.#...#.#.#.#.#.#.#.#.#.........#
#.###.#####.#.#.###.###########.#.#.#####.#########.#.#.#.###.###.#.#########.#.#.#.###.###.#####.###
#...#.....#.#.#.#.......#...#...#.#.....#.......#...#.#.....#.#.#.#...#...#...#.....#.#...#...#.....#
#.#######.#.###.###.###.#.#####.#.#####.#####.#####.#.#.#.#.###.#.#.#####.###.#.###.#.#.#########.###
#.#.....#.#...#.#...#...#...#.#.#.#.....#.........#.#.#.#.#...#...#.#.#.....#.#.#...#.........#.#...#
#####.###.#####.#####.#.###.#.#######.#########.#########.#.###.###.#.#.###.#######.#########.#.###.#
#...#.....#.#...#.#...#.#.........#.#.#.#...........#.#...#.#.............#.#...#...#.#...#...#...#.#
#.###.#.###.#####.#.###.###.#.###.#.#.#.#.#.#.#.#####.#.#######.###.###.#######.#.###.#.#.#.#####.#.#
#...#.#.#.........#...#.#...#...#.#...#...#.#.#.#...#...#.......#...#...#.............#.#.#.#.....#.#
###.###.###.#.#.#####.#.#######.#.#####.#.#####.#.###############.#.#######.#.#######.#.###.###.###.#
#...#.....#.#.#.#...#.#.#.......#.#.#...#.....#...#.#...#.#...#.#.#.......#.#.....#.....#.#...#.....#
###.###.#.#####.#.#.#.###.#####.###.#####.###.#.#.#.###.#.#.#.#.#.###########.###.#####.#.#.###.#####
#.......#.#.....#.#...#.#...#.....#...#...#...#.#...#.#.....#.#...#.........#.#.#.#.......#...#.....#
###.#.#.#####.###.#####.#.###.#.#.#.#####.#######.###.#.#.#.#####.#######.###.#.#.#.#################
#...#.#.....#.......#.....#...#.#...#.#.........#.#...#.#.#.#.#.......#.........#.#...#.....#.#.....#
#.###.#######.#.#####.#.#####.###.#.#.###.#.###.#.#.###.###.#.#####.###########.#####.#####.#.#.#.###
#...#.#.#.#.#.#.......#.#.#.....#.#...#...#.#.#.#.....#.#...#...#...#...#.#.......#.....#...#.#.#...#
#####.#.#.#.#.#####.#.###.#########.#.###.###.#.#.#.#.#####.#.#########.#.#.###.#######.#.#.#.#.#####
#...#.#.#.#.#.#...#.#.......#.#.#...#.#...#...#.#.#.#.........#...........#...#.#.#.#.....#.....#.#.#
###.#.#.#.#.#.#.#######.###.#.#.###.###.#.###.#.###.#####.###.#.###.#.#.#.###.#.#.#.#.#.###.#####.#.#
#.....#.......#.....#...#.........#...#.#.#.#...#.#.#.#.....#...#...#.#.#.#.#.#.#...#.#.#.....#.....#
#.#.#.#.#####.#.###.#######.#######.#####.#.#.###.###.#####.###.###.#.#####.#.#####.###.#####.###.#.#
#.#.#.....#.#.....#.#...#...#.....#...#...#.#.#...............#.#.#.#...#.......#.#.......#.#.....#.#
#.#####.###.#####.###.###.#.#.#.#.#.#.#.###.###.#.#.#####.#######.###.#.###.###.#.#.#.#.#.#.###.###.#
#...#.........#...#...#...#.#.#.#.#.#.#.#.......#.#...#.....#.#.#.#.#.#.....#...#...#.#.#...#.#...#.#
###.#########.###.###.#########.###.###########.#####.###.###.#.#.#.#######.#######.#.#.#####.###.###
#.#.#.........#.#...........#.......#.#.........#...#...#.#...........#.......#.#.#.#.#...#.........#
#.#####.###.#.#.#.###########.#.#.###.#.#.#.###.###.#.###.#.#####.###.#####.#.#.#.#.#####.###.#####.#
#.....#...#.#.#.#.#...#...#.#.#.#...#.#.#.#...#.#.....#...#.#...#...#...#...#...#...#.#...#...#...#.#
#.#.###.#####.#.#####.#.###.#####.###.#.#.#.###########.#####.#####.###.#.###.#######.#######.#.#.###
#.#...#.#.....#.............#.#.#.....#.#.#...#.....#.#.....#...#...#.......#...#.........#.#.#.#...#
#.###.#.#####.###.#.#.#####.#.#.#######.###.#######.#.###.###.#####.#.#######.#########.###.#.###.###
#...#.#...#.#...#.#.#.#...#.#.#.#.........#...#.......#.......#...#.#.#.......#...........#.......#.#
#.#.#.#.###.#.###.###.###.###.#.#.#######.###.###.###########.#.###.#####.###.###.#.###.#.#########.#
#.#.#.......#...#.#.#.....#...#...#...#.#...#.....#.......#...#...#.#...#.#.......#.#...#.#.........#
#.###########.#.###.#.#.###.###.#.#.###.#.#.###.#.###.#.#####.#.###.#.#####.#######.#####.#.###.#####
#.#.#.#...#.#.#.......#...#...#.#.....#.#.#.#...#.#.#.#.....#...#.....#.#...#...#.#.#...#...#.#.#...#
###.#.#.#.#.#####.#####.#####.###.###.#.###.#.###.#.###.#.#.#######.#.#.#####.###.###.#.#.###.#.###.#
#.....#.#.....#.......#...#.#.....#.#.#.#.#.#.#.#.#.#.#.#.#.....#.#.#.#...#...#.#.#...#...#...#...#.#
#.###.#####.#.###.#######.#.#####.#.###.#.###.#.#.#.#.#.#.#####.#.###.#.#.#.###.#.###.#.###.###.#.#.#
#...#.......#.#.....#.#...#.#...#.....#.#.......#...#.#.#...#.......#.#.#.#.#.#.#...#.#.#.#.....#.#.#
#.#######.#####.#.#.#.###.#.###.#####.#.###.#.#######.#######.#####.#####.#.#.#.###.#####.###.###.#.#
#...#...#...#.#.#.#.#.....#.#...#.....#...#.#.#.#...........#.#...#.#...........#.....#.#.....#.....#
#####.#####.#.#.#####.#.#.#.###.###.#.#.#.#####.###.#.#####.#####.#.#.#.#.###.#####.#.#.#####.###.#.#
#.....#.#.....#.....#.#.#...#...#.#.#...#.#...#.#...#...#.........#.#.#.#...#.#.#.#.#.#.....#...#.#.#
#####.#.#####.#.#####.#######.#.#.###.#.###.###.#.#####.#######.###.#.#####.###.#.#.###.#.#.#.#.###.#
#...#.#...#.......#.....#...#.#.......#.............#.#.#.#.......#.#.#.#.....#.......#.#.#...#.#.#.#
#.###.###.#####.###.###.###.#########.###.###.#######.###.#.#.#.#.#.###.#.#######.#.#.###.#.#####.###
#.........#.#.....#.#.#.#.#...#.....#.#.....#...#.......#...#.#.#.....#.......#.#.#.#...#.#.........#
#.#.#.#####.#####.#.#.###.###.#.#.#.#.###.#.#.#.###.#####.###.#.#.#####.#.###.#.#.#######.#########.#
#.#.#.#.....#...#.#.......#.....#.#...#.#.#.#.#...#.....#.#.#.#.#.....#.#.#...#...........#.....#...#
#.#######.#.#.#.#.###.#####.#.#######.#.#####.###.###.#####.#######.###.#####.###.#######.#.#.#####.#
#.....#.#.#.#.#.#.#.......#.#.#.....#.......#.#.......#.....#...#.#.#...#...#.#.....#...#...#.#...#.#
#####.#.###.###.#####.#.#####.###.#####.#############.#.#.###.#.#.#####.#.#####.#######.#.#.#.#.#.#.#
#.#...#.#.#...#.#.....#.#...........#.#.#.....#.#...#.#.#.#...#.#.............#...#.......#.#...#.#.#
#.#.###.#.###.#.###.###.#########.###.#####.#.#.#.#.#.###.#.#.#####.#######.#.#######.#.###.###.#####
#...#...#.#.......#.#.#...#...#...#.....#...#.#...#...#...#.#.....#.#...#.#.#.......#.#.#...#.#.....#
#.#.###.#.#.#.###.#.#.#.###.#.#.#####.#######.#####.###.#.#.#####.#.#.###.#.#.#############.#.#.#####
#.#.........#.#.....#.#.....#.#...#.#.....#...#...#.....#...#.#.........#...#.#.........#...#.....#.#
#.###.#####.###.#.###.#.#####.#.###.#.#.###.###.#.###.###.###.#.#############.#.#.###.#####.#.###.#.#
#.#...#.#.....#.#.#.#...#.....#.......#.#.......#.....#.......#.#.#.........#...#.#...#...#.#...#.#.#
#.#.###.###.#.###.#.#######.#########.###.#.###.#.#####.#.###.###.#.#.###.#####.#######.#.#.###.###.#
#.#.....#...#.#.....#...............#.#...#...#.#.#.....#.#...#.....#.#...........#.....#.....#......
#####################################################################################################
